Tsai_EMX1	GAGTCCGAGCAGAAGAAGAAGGG
Tsai_FANCF	GGAATCCCTTCTGCAGCACCTGG
Tsai_HEK293_sgRNA1	GGGAAAGACCCAGCATCCGTGGG
Tsai_HEK293_sgRNA2	GAACACAAAGCATAGACTGCGGG
Tsai_HEK293_sgRNA3	GGCCCAGACTGAGCACGTGATGG
Tsai_HEK293_sgRNA4	GGCACTGCGGCTGGAGGTGGGGG
Tsai_RNF2	GTCATCTTAGTCATTACCTGAGG
Tsai_VEGFA_site1	GGGTGGGGGGAGTTTGCTCCTGG
Tsai_VEGFA_site2	GACCCCCTCCACCCCGCCTCCGG
Tsai_VEGFA_site3	GGTGAGTGAGTGTGTGCGTGTGG
Cho_c4bpb	AATGACCACTACATCCTCAAGGG
Cho_ccr-1	GAATCCTAAAAACTCTGCTTCGG
Cho_ccr5-2	GACACCGAAGCAGAGTTTTTAGG
Cho_ccr5-3	GGTCCTGCCGCTGCTTGTCATGG
Cho_ccr5-4	AAATGAGAAGAAGAGGCACAGGG
Cho_ccr5-5	CCTGCCTCCGCTCTACTCACTGG
Cho_ccr5-6	ATGAACACCAGTGAGTAGAGCGG
Cho_ccr5-7	AACACCAGTGAGTAGAGCGGAGG
Cho_ccr5-8	CCAGTGAGTAGAGCGGAGGCAGG
Cho_ccr5	TGACATCAATTATTATACATCGG
Wang_WAS_CR-3	GATTCTTCCCTGTGTCTCTGGATGG
Wang_WAS_CR-4	TGGATGGAGGAATGAGGAGTTGG
Wang_WAS_CR-5	CCCATCCATCCAGAGACACAGGG
Wang_TAT_CR-4	ATCTTTAGTGCTCTTATAACAGG
Wang_TAT_CR-1	TCCTCCTGAGACTCCATACCTGG
Wang_TAT_CR-6	GGAGCTTACCGATGGATGGGG
