#Supplementary Data 1 - List of high and low activity sgRNAs for Cas9Sp and Cas9St1			
#Cas9Sp nuclease		Cas9St1 Nuclease	
#High activity	Low activity	High activity	Low activity
CGTCCAGCCGGTGAGCATCCAGG	CAGGCGTCTGCGAAATCATATGG	AGGAAGTTTTGTGTTTGGAGACAGAAA	GGGGTGGTCCATAAAGCCCATGAGAAT
ACCACCGGACCCTGAGGCGCAGG	TGGAACTTTGCAGCCGTCATCGG	ATTCCTCCGGATGCTCACCAGCAGAAA	ACAACTTCCTTCGGAGTCTGCAAGAAA
ACCACCGGCGCGAATGAGAGCGG	CAACCCACTACGTCATAGCATGG	TTGATGTGGTACACTAAGCGCCAGAAA	CACCCAGTACACCACGCTGATGAGAAT
CCCTATCGAGCGTACACCAATGG	AAGGCCACCGACCGCTTCCGTGG	CCCAGGTCCAGATGAAGCTCCCAGAAT	CAGAACATTAATTTGGTTACACAGAAA
GAGAGCCGAAGATAAAGAACTGG	TGCGTCAACTGGCGCGGCTCAGG	TCCTCCTCCTCCTCGGGCAGTGAGAAT	CAGCAGTATGGTGCTGAAGAAAAGAAT
GATTGGCTATACGTCTGTCACGG	TGCTGTATGTTACTGTGCTCCGG	GATGTTAAATGCACCAACACATAGAAT	CTATATGGGTTTTACTTTTGCCAGAAT
CAGGATTCCAGCGTAACTTGTGG	TGGAATGCCCGAGATTCCTCCGG	TCCAAACAGAGGTCCGAAGGAGAGAAA	CAGGTTCTTGGTCCTCAGGAATAGAAT
GTTCTCATCGCGTACCACGAAGG	CTGTCTGGACGCGAAGCAGTAGG	TGCTTTATATGGTTTAGAAGTAAGAAT	GTTCTTCCGGAAGTTGTCATCTAGAAA
GGACTGCTTCACGGTCAACGTGG	AACTCTACACCTAGTGAGGGGGG	CTTGTTCCCAGGGAACACAGTGAGAAA	GATGCAGTTCTTTGACTCCATGAGAAA
AGGTCCGACGATCACCTTCATGG	GGAATCTTCGAGTATGCGGACGG	GGTACACAATACAGAATGGGAAAGAAA	ATCCTGGATGGTGGACAATAAAAGAAT
TACCCCGATACGAACATACCAGG	AACCTTTGTGAGCGAGTTCCCGG	TCAGGGTGGCTTCCAAGGCCTTAGAAA	GCCCAGCCGCGAGGCCTGGTCCAGAAA
ATAAGCTGATGCGGACGGTGGGG	TCGCTCCGGGTGGAGCGCGCCGG	GTGGGGACCTTTACCAGGCATGAGAAT	AGCCCGCCTGCTCTATGAGAGCAGAAA
GGCGAGCGTCAGCAGGCGCATGG	TTAACAGGGAATATATAAGGCGG	GACGATGGCACCATAAGAAGTGAGAAT	GATATCATCCTGTTTTTGGCCAAGAAA
ACACCTACCCCAGCAACGACCGG	GTATTTTCGACAATTTATTACGG	TTGACTCTCAATCCAAGGGGCCAGAAA	GAAAGGAGGGGGAAGCCAACCCAGAAA
TGCTTTCGTCTGCTTGTAGGCGG	CAGTCTATCTTACTTTTACTCGG	AGTGCTACAAGATACATGGCACAGAAA	AGATTTTCCACCTGTGACAACCAGAAA
AGATCCAAGACTGCAGCCAGTGG	CTCCCGGTCAGTTCGGGATGTGG	AAACAGGTGGAGACTCAGCCTGAGAAA	CTGTTTGGCAGGTGAAGTTTGAAGAAT
CTTGAGCGAGCCCCGCTTGAAGG	ATCCGGCACGATCCCCGATTCGG	CATGGTGACCTACGAGGGCGACAGAAA	AGCAGAAATGCTATTCTTGTGGAGAAT
CACGATGTAGGTGACGAAGGAGG	ATATACCCCTCAGGGGTTATTGG	CCGAGAGCTCAGACCGGGAAAGAGAAA	CAGGAGGGCCCTGTTTGAAAAGAGAAA
CACACCACTACACCATCGAGCGG	AATGCTTGGAACGAAGATCATGG	GCCTTGGAACACGCGCACCACAAGAAA	ACAGCCAAATGTTGTGCTTATCAGAAA
GTAGTTCTTTCGCTGTAGCAGGG	TTTGGTACCGTGGAAACGCCAGG	AGCTACCCTGTTCATGGTGCTGAGAAA	GCCTCCGAAGGACACGTTGACCAGAAT
TCCACGCCGATGCCGAACAGCGG	CGTCAGAGATGGCCAGGACCCGG	CTAACTGGTCTGGATTACAGACAGAAT	GCATTTTGGGCAGCGTTGTAGAAGAAA
GGTCCAAGATGTTGCAGACCGGG	CTCGTGGTGCGGTGCGCTTCTGG	AGGAATCATTCACACCATAGGAAGAAT	GCTTAGTGTTCTTTCTGTCCACAGAAT
CTTGGTCTGGCGAACCTCCGAGG	GGGGGTTCCGTTCATCAATAAGG	GTGTCCACGACCTCAGAACCTGAGAAT	CCCGAGAACCGCATTAGTAAGGAGAAA
GAATGACATCGGCGACTACGTGG	AGCTTCTCGTTCTCAGCGTGCGG	TACAACAGCTATATGGACGAGAAGAAT	AATTCCGCTGTGACTGCTTTCCAGAAA
GTGATGATATTAGTGACCAGCGG	CTTTTCGATCTCGTACTATTAGG	AGCAGCTACCGGCGCGGGCGCAAGAAA	GGTACATCTGCAGTAAGCAGGAAGAAA
CTAGCGGCCCGGGAGGAGTAGGG	TCGTGCTGAGCTTCCAGCCGCGG	GGGTAAGCAAGAAACACAAGTTAGAAA	ACACAAATGGCAGTGCAATCACAGAAT
AGGCGCTCGTACTGCACATGGGG	ATGGACATATTGGAGGTCTCGGG	GAGGGTTTGTAAATGGAAGCAGAGAAA	GTCGTAATGACAGTTCCAGCAAAGAAA
CCTTGGATGGCCTTATTCGGAGG	CGGCTTCGTGCGCTTCTTTCAGG	GTCACTATCACCAAGGGGAGGCAGAAA	ATGATCGTTGTGTTGTACAGCCAGAAA
TGTATGCCGTACGGAGTGAGCGG	CGTTCGTGGCAGGGGTTATTCGG	CAAGCTCCCAGGGAATCCCACCAGAAT	CCTCACAAGTCTGGCCATATCCAGAAT
ATTGGTTGTCCCAGGACGAGTGG	GTTTTTTTAGATTTCGGCAATGG	ACCACCACGGCCAGGGGCAGGTAGAAT	TTCAAGCAAATTTTAAGAAACGAGAAT
ACATCGAGCGTGCACTGCCGCGG	CGTCTCGTAGTCCCAGAGGGCGG	AGATGAGCAGGATTACCATGAAAGAAA	AGCCACGAGCAGTGGTGGCCTTAGAAT
GAGGATCCAGTAGAACTTGGCGG	GCACTCGATCCGTGCCCGAGTGG	TGACGGTGGTTGCATTGTGGTAAGAAT	TTCGAAACATAAGTTGCATTACAGAAA
AGTGGTTGACGAACTCGGTGGGG	TGGTTTAGAGTAGGTTTTCCCGG	TGCATACTGGGCACCCACCATGAGAAA	AAATGCACATATTTTTATTGGTAGAAA
TGACCAGCAGTACGAATGCGTGG	AACCGCTGCCGCTTCTTCTTGGG	GGTGGTGGCTAAATACATACAGAGAAA	GATCGACTGATCATTTTCAATCAGAAT
ATTATGACCCTAACGAACAGTGG	ACGAGCCATCGTCATGATTCAGG	TGAAGAATCATACAAGGCAGATAGAAT	AGAAGGAGTATGTGGAGTGTCTAGAAA
GTGTGGTTAACTGTGATCGGAGG	TGCTGACCGGATCCGTAAAATGG	GAGGCAGCAGTTCTAGTCCCCCAGAAA	TGGGTACACAGAAAAGCCAACAAGAAT
CTTGCAAACTCAGTAGCCCGCGG	AGGCGTGACAATCCCTTCAATGG	GTCTTCATTCCCATTGGGCGTCAGAAT	CAGGTAGATGGTTAGAAATGTCAGAAA
ATGAACGTCTCGGGCTGCCCAGG	AATTTCACAGCGCTTGTTTACGG	TCAGACCTGTGAACTACCCAGAAGAAA	AGAGCCAAATCTTGAATCTAGAAGAAT
TGATGACGTGACCAGGCGCACGG	GTGTTGACTGCGTTCCATACCGG	TTGGTCAGTTTCTACGGAGGAAAGAAA	CTTGGATGACCTGTAGAGAGAAAGAAA
GGAACTCGGAGACACTCGACTGG	GCGCGACTCCTTTTCTTTAGAGG	GCCAGTGGACAACAAAAGAAGCAGAAA	ATGATCCTGTATGACCTGCAGCAGAAT
GATTCGAATATCTCTCTTCGTGG	TCTACATTTATGATGCCGACCGG	AGGATCTGTGTGAATCCGGCTGAGAAA	AGCATGATCTGTCAATCCCAAAAGAAT
GCATGACGACCTATGATGATAGG	CACAACAGATAGACTATGCTCGG	AGCAAATAGAAACATGACAAAGAGAAT	ACATCAAAACCCATCTTGATGAAGAAA
GTCTTCCTGTTTAAGCCCGGGGG	TGTGGGCTACCTACACGTACCGG	CGGCGACCACATGAGCTCCTACAGAAA	AGGTCGATCTGAGAAACCCAGCAGAAT
TCGGGAGAAAGGTCGCTGTGTGG	ACAGAGGCGTTCGTCGTACCAGG	TGGTGGGTCAGAAGTTGGTGGGAGAAA	CCAACTCTGTTTGTTGTGCTTTAGAAT
GCACAACGCCACTCTCCACGGGG	CACGTGATCGCTCTTGTTCCAGG	GGGAGACGGTGCAGAAATGGCGAGAAT	TTGAGTAAATATGATGACAACCAGAAA
GGTGTTGTCGATGCGGTGGACGG	AACTCTCGCACCGTCATGAACGG	GCGTGGCTGCAGTCGGGGCAGAAGAAA	TAGAGGCACTGTCATCATCCTCAGAAA
GGGATCTAGGTCTATGATCGCGG	TGAGATGCGTCATAGACGGTTGG	TCCTCGGTGGTGCCTGGGCCCAAGAAA	GGTTTCATTCGTCTCATTTTGAAGAAA
CGTGTCAGTGACGAGTAAAGAGG	TCTTGGTCACGTTGTAGCCGAGG	AAGATGATGAAGAGGCCCCCGAAGAAA	CTTGAAATCCTTGGCATGCTGGAGAAT
TCTCGAGCTGCGCTAATGCCTGG	AGTTCGTCACGTTGTGCAGCCGG	TGGACCGAGTTTGTGGAGGGAAAGAAT	CAGGAAGACGGACTCGCAGTGTAGAAA
TCGCAGGGAGGCGCCACCCGGGG	TCGTTGCGGATGTCGATGCCTGG	TTCATCTGGAAATACAGGAGGAAGAAA	ATGGTGGTTTCTGTCTCTATTGAGAAT
GTTGGCGACAGAAAAGTCAATGG	TGTTTATCAACGTCATCTAGAGG	AGCAAAGCCAATGACGGACAGGAGAAA	TGTTAGATTCCCAGCAATGATCAGAAA
TGTGGGGTATAGCCGGCACATGG	GACGACTTCGGGCACAGCAGAGG	GGTGTCCCTGGAGCAGGTGTCCAGAAT	TGGAGTTAGGCTGGTGCCATTTAGAAA
GAACTCGCGCGAGCCCTCCCAGG	GTCTTCGTCGCCAGCTGTAACGG	AAGCTGAGCAGAAGCAGGCAGAAGAAA	CACATCTCGTTCTCGGTTTATCAGAAA
CAAGATGATCCAATCCCACGTGG	AGAAAAGTCTATGGCTACGTCGG	GTGAGGTCCTCAAATGTTCGGGAGAAA	GAACCTCTGGCTACAAAGCTCCAGAAT
GATTGTCGGAAAGTCCTAAGAGG	GGGCGTGCGGCTTCCCCTTCGGG	GCGTGCGGTTCCTGAAGACGTCAGAAA	AGGGTTAAGCTGTAGAATAGCAAGAAA
GTCAGACTGGAGCACGTACCCGG	CCTCTATACTTCTTATATTGCGG	ATAGTTAGAAATGCCAATAAGGAGAAA	GTTTACTGGCTCCAGAAAATTCAGAAA
CAACAAGGAGCTCCGGCCCGTGG	GCGGGCGAAGCGCCCGACGGCGG	TGCGTCAATGCCATGGAAGGGAAGAAA	CCCAATGGTACGCTGATCATCCAGAAT
TGAAGTGCGAGGTATGATAGGGG	TGATTGTCGAAGAACCATTTCGG	CCGGCTCTGACGAAACGCTGCGAGAAT	TTGCTTGCTGTTTAATCCTCTGAGAAT
CGAGACATACCGCTACCTGACGG	CGAGGATTTTGCGGATGAGATGG	GCTCCTTCTTGAAGATGCAGTCAGAAT	GACCTGGAGTCATGGTCTTTGCAGAAA
GCGGCGGAGAACGGAAGTCGTGG	CCAATTGCCTTCAGATCAATAGG	TAGAACTTGGCGGTCAAGAGGAAGAAA	AAATCTCTGATATGCCTTCATGAGAAT
ACTAGTCCTCGAAAACCTCGTGG	CATCTTTATGTTCTGCGCGATGG	GAAGATGTAGTTGGACACGGTGAGAAA	ATTTTTCAGATAGATTGTCAGCAGAAT
GCGTAGACACGGAAGAGCGAGGG	CATTCGTGTTTGGGTTCATTGGG	AGCTGCTCGTCGGGTGGCGGGAAGAAT	GCAACTGGGAGCTTGACTGTGAAGAAT
TAACACCAGCCCCAATGCGTCGG	AGCGTACCCCCAGGTCTTGCAGG	TGCCGGCTGTACGCGGAGTGGCAGAAA	AAGATCATGTTGTTCTTCAGGAAGAAT
CGCACAGGGACACGTACTGAGGG	CAACTTCCGTCGCTTTACTCCGG	CAGGTGGGAGAAGCCGAGAAGAAGAAA	GGCTCCAGTTGCGGCCAATCTGAGAAT
ACCACAGCATCATGACCGTGAGG	GGAAGTGATCTTCTATCTGTCGG	GATGGCCTGAAGGGGCGGCATGAGAAA	CTCCAGAAAGGACATATTAGCTAGAAA
TGCTGACCGCGATACCCAGGAGG	CGAAGGGCATTAATGAGTTTAGG	CCCGGCGAACACAGGCGCGGAGAGAAA	GCTTCCCATTACTGGCCACTGGAGAAT
TCCCCGATCCAGATCTTCCGCGG	ACGTGCGGAACTTTAAAGCCTGG	GTTTAGAGCGCTAAAGAAGGTGAGAAT	TCACAAGGCCGCCGGTTGATAAAGAAA
CTGGCTGACCGCGCGAACGCCGG	CTCATTCCAGGCAATTGAATCGG	GCAGCAGAGCTGGAAGGTGGCTAGAAA	CCATGGCGAGTCCCCAAAATCCAGAAA
CGCCACGACAGTCGCCCCCGCGG	TCTTGTATTGCACAAGGACCAGG	CAATCATCCCTGCCGGACAGACAGAAT	GGGATCACTTTCCTACAAAAGGAGAAT
CCATGACGGCCAGCATTGAGAGG	ATGCACGGAGTGCATCGTCCTGG	ATGACGGCCAGCATTGAGAGGAAGAAA	
GACCGCCGCACTCTAGTAAGTGG	CGTTCTGCGCTTTTCCGAGTCGG	GCAAGGACGACTTTGGGGGTATAGAAA	
TCTGATGTGCTCAGCCCGAGCGG	GCTCTGCTCCGTCTTCTTTACGG	CAGCCTTTTGTAATATCCGGTAAGAAT	
CAAGCTCGCTGATATCTGTCTGG	CTCGGCCCTCAAGTGGCCGTCGG	GTGCCTGTGAAATGAATGGGGAAGAAT	
GTCTGGATAATCTAATGAGCTGG	GAGCAATGCTCGTGTGGAAGTGG	GAGTTACCCACCGAGGCCAGAAAGAAT	
ATGCGTGACAGACACGGGCATGG	ACCCAAAATTCGACCTTTTCGGG	ACCCTGCATGACAAGGGGTAGGAGAAA	
CACCCGGAACCGCACATCAGTGG	GTCAGCGCCCTGGGACTACTCGG	TGTCGGGGACAGTGATCGCTGGAGAAA	
TAGCAGGCCGTCGCCCCTGGCGG	GATCAATGCATGCTGTGAATCGG	CATGCCAGAAAATCCAGTGAGAAGAAA	
GACGACCGAGCGGTCAGCGAAGG	GATTCTGTCAGCTACGAGTATGG	CATCCTGTAAATTAGGGCCCCCAGAAT	
TCTGGACGTCCTGCTCACAACGG	ATGATCTTCAAGTAGCGGAAGGG	TGGTGTTGGGGAATCCTCCGTGAGAAT	
TCTTGTAGTCGAACAGCGACAGG	ACCTATTCCAACAGCACCATCGG	GGAAGAGGAGGAAGAAGAGGCTAGAAT	
AACATGCTAATGAGTCCCCGTGG	TGCGGCGCAGACATACAGCTCGG	ACAGTCAAGATAGCAAGAAGGTAGAAA	
TAATCTTCTGCTGTACACTGCGG	CGGAGCGTGTGCTGAGACGCCGG	GTGGTTAGTGAAGTTCCCAGTGAGAAT	
GCAGGAACCTCACCTACGTGCGG	AGTGCGGGGCGTACATCTCCTGG		
GGCTCGTGCTGGCATCTACGGGG	AGACAGACACTCGGTAGCAACGG		
GTCTCTGAATAGATGGTATGAGG	GTGCAGGTCGTTGCAGGGCGCGG		
GCGCGAGTGCTTCTGGCGTGTGG	TAAAGAACAGTCGTGATCCCCGG		
TGGTCCTGTTCAAATACAAGCGG	GGATCAGCCACTTCTACGGAGGG		
AGAACTTGCCTTGCTCCTTGCGG	ATTTGACACAATTGTCTTGCCGG		
ATCACGAGTTCACGATACCGTGG	TAAATCTTGTTCGGATGCTCTGG		
GGTCTCTCCCGCGAGGCGCTGGG	GTATCAACAACACACGTTCCCGG		
CATCCTCGACAGTTGCTCCAAGG	TTAGCAGTATCCGCCGTCACCGG		
AGAACACGCTTCGAAGCTTGAGG	GAATCAAGACGACAAGAACCCGG		
GATTCTGGATGGCGACGTAGCGG	ATTGGGCACATTATAGCGTTTGG		
GGCCAGCAACTACGGCGTGTCGG	CGCCACCTTGATCCTTTTGTCGG		
GGAGTCGGCCGACTTCTACGAGG	ATGGCGGATGAGCCACTCAATGG		
CACTGTCATTGCGAGCCCGACGG	AAGCTATGGGCTGACACCTTCGG		
TTGTGGTCAATGTCACTCCGAGG	CGCATCCCAACGTCGACGGGGGG		
CAATTACACGCTGGCACCAGAGG	GGATCACTTCGCGCACGCTCTGG		
CGTCAACGAGAACACCTTCAAGG	GCATCAGTGTGCGACGATTTTGG		
TCTCGGTACCGTGCCGGGAAGGG	CTCGGGGGACCGGTAGGTAACGG		
AGTCCGGCACCGAGCCCTGGCGG	CGTTTTCCCTAAAGATAAGCTGG		
CTGCAAGGCCCGGCGCACGGTGG	CGCCGGGCTTTTTCAACTTGTGG		
GCGGCGGTAGCGCTTGTGCGCGG	CATAAGGATTCGCTCACTCCAGG		
CTTCTACTATGAGAGCGATGCGG	AGTGCATTCTCGGTCAGTCAAGG		
TCCATGGTCCGCAGCATGGGGGG	TTGGCTCGAAACTTGTCGCAGGG		
GGTGCAGCTCGAGCAACAGGCGG	CACCATCGTGGGGCTCTACCTGG		
CCATCGTCCGAGCTATACTGAGG	TACACAATATTGTTCAGAACCGG		
GGCATCGGTGGGCTTCTCCGTGG	TAGCCAGGTAGCCATACTCAGGG		
AAGCTCAGCCTCGTTAAACGTGG	CATCATCCGCTCAACCGTGCTGG		
CCGCAAGGGCATCATCCCCGAGG	CCTTACAACGTTTGCTTTATTGG		
GGCGATCACGGCCATCACAGCGG	TCGTGATAGGTGACCTGGAGCGG		
ACAACGGGGACAGAACGCCCCGG	ACCCCAACGCCTTTCAACCATGG		
ACGGATAAATGGCCACCACCAGG	ATATATTCTACGTAAGTTCCCGG		
GTATTGGTTCTCAGCATCGCCGG	TACTTCCCTTCGGTACTTTAAGG		
CAGACACGTTGGCTACAGGCCGG	GGTCTGACCCAATTAACACACGG		
TATTCGTACCAACTATAGCACGG	TCAAAATGTTCACTAGCTGCCGG		
CTACACCGATTACCTCCAGACGG	CTCCAACTGATAACAAGAACGGG		
AGCGATGCCGGACTCCCCAGCGG	GCGCTGCTGCAGCGCTCTAGCGG		
ATCAATAGTGTCATGGCATGTGG	GGCGCCTGAGGGCCCGTCACGGG		
GATATTAGTCGACATCTGCGGGG	GGGCAGAACTACCCGCGTAGCGG		
GGTCCATGCCCCGGCCACCACGG	TACCGTCAGGATCAAGATTATGG		
GTAGAAGGCGGCTCGGAGAACGG	CGTTGTACAGGCGAATCTTCGGG		
GACGATGGCATTACCCGTCACGG	AACGCTGCTGTCAACTATTCAGG		
GAGCGATAACGATGACATCGAGG	CGCTGAGCGTTGCTCGCTACTGG		
AGCACCACGGCGCGCTCCGACGG	CAACGCGCGCTTTCTGCTGCTGG		
TCCATCCTACAGCTCGCTCTTGG	CGAAATTTGCCCGATTGACACGG		
ATTGACAGCGTAGATGTCGGTGG	TCCGACGCCAGCGGCGGCTTTGG		
ACCATCGCTACGCGCTTCGACGG	TCCGCCTGCGAGGCACGTAACGG		
ACCGAGAAGTAAGTCCCAAATGG	CCCCGACGGCGCCAGCTACCTGG		
GAGACCGGCGGCAACACTACTGG	ATCCTCCATGGTACTGTGTAAGG		
AATCTCGACAAGCTCATATGTGG	GAAACAGCTCGTTGTACCGCTGG		
CAAGCCGTGGAGTGCTGCCAAGG	TAGTATACGGAGAGCATCTTCGG		
TCTGGCGCGGATGAACCCGCAGG	CGACGGGGGTTTTGTGCACTCGG		
	TGCTGATCCGCATGGATGCCCGG		
	CTTGGCCGTTGTGACTCTCATGG		
	CCGTGGTCTTTGTTATAGCCCGG		
	GACCGTGCGCACCGCGTGCTTGG		
	TTCAGGCTCTCATTAACTAAAGG		
	CGAGTGGGCGCTCAGTTTTCGGG		
	CACGGAAGACATGAGTCCCACGG		
	ACACTGTTAGGCTCCAATCTCGG		
	TCCGTGCAATTGCCTATACTTGG		
	CGCTTTAAGTACTCTGTTAAAGG		
	CGTCGCGGTAGATACCCTCTTGG		
	CATTGGACTCTGCGCCATAGTGG		
	GGTGTCGGTTAAGCTGTTTTTGG		
